1111111110
1000000001
1000000001
1111111111
