1111111111
1000000001
1000000001
1111110011
