1111111111
0000000001
1000000001
1111111111
