1110111111
1000000001
1000000001
1111111111
