1111111011
1000000001
1000000001
1111111111
