111111111111111111111
1C00000000000000000C1
100000000000000000001
100H0000000000000V001
100000000000000000001
100000000000000000001
100000000111000000001
100000001000100000001
1000000100E0010000001
1000000100P0010000001
100000010000010000001
100000001000100000001
100000000101000000001
100000000000000000001
100000000000000000001
100V0000000000000H001
100000000000000000001
1C00000000000000000C1
111111111111111111111
