1111111111
1C0P000001
100C100011
1000000001
1111111111
