1111111111
10000CPE01
1000000001
0111111111
