1111111111
1000000111111
1111111111
