1111111111
10CPE00001
1000000001
1101111111
