1111111111
1C000E0001
100C100011
1000000001
1111111111
