1111111111
1000000001
1000000001
0111111111
