1111111111
10000CPE01
1000000000
1111111111
