1110111111
10000CPE01
1000000001
1111111111
