0111111111
1000CPE001
1000000001
1111111111
