1111111111
100P0E0001
1000100011
1000000001
1111111111
