1111111111
10000CPE01
0000000001
1111111111
