1111111011
10000CPE01
1000000001
1111111111
