1111111111
10000CPE01
1000000001
1111110011
