1111111111
10000CPE00
1000000001
1111111111
