1111111111
1C0P0E00X1
100C100011
1000000001
1111111111
