1111111110
10000CEP01
1000000001
1111111111
