1111111111
00000CPE01
1000000001
1111111111
